#################################
#                               #
#                               #
#                  #####        #
#                  #####        #
#                  #####        #
#                               #
#           X                   G
#                               #
#                               #
#################################
