#################################
#                               #
#        ##                     #
#        ##        #####        #
#              #   #####        #
#     ##       #   #####        #
#     ##       #                #
#           X                   G
#                               #
#                               #
#################################
