###############################################################################
#                                                                             #
#                                      O                                      G
#                                                                             #
###############################################################################
