#####################################
# #       ##  #                ##   G
# # ####  ##  #   # #    # #   ## ###
# # #  #          # #    # #   ## ###
### #  ########## ###############   #
#        #    # # # # #  # # # #### #
#        #    # # # # #  # # # #### #
#######    #  ### ################  #
#   #      #    #              ### ##
#   #      #    #              ### ##
#   ########   ############### #   ##
#         ##             # # # # # ##
# ###  ###### ### ########## # # # ##
#   #  #   #  # # #          #   #  #
#   #  #   #  # ###          #   #  #
#   #  ###### ###    ##  ##  ##### ##
#   #  ##  #          #  #   #      #
#####  ################  #   #  #####
# X                      #   #      #
#####################################
