###############################################################################
#                                                                             #
#                                      X                                      G
#                                                                             #
###############################################################################
